    ⠀⠀⠀⠀⠀⠀⠀⠀⠀⠀⠀⠀⠀⠀⠀⠀⠀⠀⠀⠀⠀⠀⠀⠀⠀⠀⠀⠀⠀⠀
    ⠀⠀⠀⠀⠀⠀⠀⠀⠀⠀⠀⠀⠀⠀⠀⠀⠀⠀⠀⠀⠀⠀⠀⠀⠀⠀⠀⠀⠀⠀
    ⠀⠀⠀⠀⠀⠀⠀⠀⠀⠀⠀⠀⠀⠀⠀⠀⠀⠀⠀⣤⣄⢘⣒⣀⣀⣀⣀⠀⠀⠀
    ⠀⠀⠀⠀⠀⠀⠀⠀⠀⠀⠀⠀⠀⠀⠀⠀⠀⠀⠀⣽⣿⣛⠛⢛⣿⣿⡿⠟⠂⠀
    ⠀⠀⠀⠀⠀⠀⠀⠀⠀⠀⠀⣀⣀⣀⣀⡀⠀⣤⣾⣿⣿⣿⣿⣿⣿⣿⣷⣿⡆⠀
    ⠀⠀⠀⠀⠀⠀⣀⣤⣶⣿⣿⣿⣿⣿⣿⣿⣿⣿⣿⣿⣿⣿⣿⣿⣿⣿⣿⡿⠁⠀
    ⠀⠀⠀⢀⣴⣾⣿⣿⣿⣿⣿⣿⣿⣿⣿⣿⣿⣿⣿⣿⣿⣿⣿⡇⠀⠀⠀⠀⠀⠀
    ⠀⠀⣠⣿⣿⣿⣿⣿⣿⣿⣿⣿⣿⣿⣿⣿⣿⣿⣿⣿⣿⣿⣿⡇⠀⠀⠀⠀⠀
    ⠀⠀⠻⣿⣿⣿⣿⣿⣿⣿⣿⣿⣿⣿⣿⣿⣿⣿⣿⣿⣿⠟⠜⠀⠀⠀⠀⠀⠀⠀
    ⠀⠀⠀⢿⣿⣿⣿⣿⠿⠿⣿⣿⡿⢿⣿⣿⠈⣿⣿⣿⡏⣠⡴⠀⠀⠀⠀⠀⠀⠀
    ⠀⠀⣠⣿⣿⣿⡿⢁⣴⣶⣄⠀⠀⠉⠉⠉⠀⢻⣿⡿⢰⣿⡇⠀⠀⠀⠀⠀⠀⠀
    ⠀⠀⢿⣿⠟⠋⠀⠈⠛⣿⣿⠀⠀⠀⠀⠀⠀⠸⣿⡇⢸⣿⡇⠀⠀⠀⠀⠀⠀⠀
    ⠀⠀⢸⣿⠀⠀⠀⠀⠀⠘⠿⠆⠀⠀⠀⠀⠀⠀⣿⡇⠀⠿⠇⠀⠀⠀⠀⠀⠀⠀
    ⠀⠀⠀⠀⠀⠀⠀⠀⠀⠀⠀⠀⠀⠀⠀⠀⠀⠀⠀⠀⠀⠀⠀⠀⠀⠀⠀⠀⠀⠀⠀⠀⠀⠀⠀⠀⠀⠀⠀⠀⠀⠀⠀⠀⠀⠀⠀⠀⠀⠀⠀⠀⠀⠀⠀⠀⠀⠀⠀⠀